                                  #####                          
                                ###...###                        
                               ##.......##    #####              
                               #.........######...###            
                               #....<......##.......##           
                               #.........##..........#           
        .           #.#        ##.......####....<....#.#         
       #.#          #.#         ###...###  #.........#.#         
       #.#          #.#           ####.### ##.......##.#####     
       #.#          #.#            ###...######...####.......    
       #.#          #.#           ##.......######### #.....>..   
       #.#          #.#           #............#...###........#  
       #.#          #.#          .#....<....##...#..##........#  
 #######.############.########   .#.........######..##........#  
...................)..........   .##.......##...(....#........#  
 ..#####.############(########   ..###...###..#.....##%.#######  
       #.#          #.#          #...#######.########...#        
       #.#          #(#          #.#..................#.#        
       #.#          #.#          #.####################.#        
       #.#          #.############.####################.#########
     ###.#          #...........................%...............#
     #...#          #......#######.####################.#######.#
     #..g#          #......#     #.#                  #.#        
     #...#          ########     #..                  ...        
     #...#                       ####                ##.##       
     #...#                                            #.#        
     #...#                                            #.#        
     #....                                            ..#        
     #...#                                            ###        
       ..#                                                       
