#########                                            ########  
#.......#                                ######      #.......# 
#.......#############                    #....#      #.......# 
#.......)..##....<..#     ########       #....####   #.......# 
#.......##.##.......#     #......######  #....'..##  #.......# 
#.......##.##.....%.###   #......'....####....##..#  #.......# 
#.......##..'.......'.#####......####....#....###.####.......# 
#.......#####.......#.....+......#  ####.'[...# #...........<# 
#...)...#   #.......#######......#     ###...)# ######.......# 
#.......#   #.......#     #......#       #....#      #.......# 
#.......#   #.......#     #.....(#       #...)#      #.......# 
######.##   ####'####     #......#       ###'####    ######.## 
     #.##      #...#      ####..##         #....#         #.#  
     #..#     ####'#####   ####..##     #######.##      ###.#  
     ##.#     #........#   #......#     #........#     ##...#  
  #####'##    #........#   #.%#####     ######%..#     #..###  
  #....%.#    #........#   #..#              #...#   ###'######
  #......#    +........#   #..#####          #...#   #........#
  #......#   (#..(.....#   #......#.#        #...### #........#
  #..)...#  (##.....)..#####.......#         #.....###........#
  #......##..##........'..##.....###         #>..#...'..f.....#
  #......'>!# #........##........#           #...#####........#
  #S.....#### #........#####..####           #..(#   #.....[..#
  #......#    #........#   #..#              #.(.#   ###'######
  ####'###    ####+#####   ####              #...#     #..#    
  #..).#         #.#      #######       #######.##     ##(#    
  #.####         #.#      #.....#       #..(....#     ###'##   
 ##.####         #.#      #.#####     ###'#######     #....#   
 #.....#####     #.#      #.#         #.........#     #....#   
 #.........####  #.#     ##'######    #.........#     #....#   
 #.....###....####.####  #.......#    #........%#     #....#   
 #....(# ####.........#  #.......#    #.........###   #...)#   
 #.....#    ######.##.####.......######.........+.#   #....#   
 #[....#        #..##....'.......'....+.........#.#   #....#   
 #.....#        #.########.......######.........#.### #....#   
 #>....#        #.#      #.......#    #.<.......#...###....#   
 #######        #.#      #.......#    #.........###...'....#   
                #.#      ####'####    ########'## #####....#   
                #.#        #..#              #.#      ##'###   
                #.#       ##'######         ##.#       #..##   
                #.#       #.......###       #..#       ##..### 
            #####'###     #.......'[##      #.##        ##...# 
            #.......#     #..<....#..#  #####.####   #######.##
            #.......#   ###>......##.####........#   #......^.#
            #.......#   #.'.......##...##........#   #........#
            #.......#  ##.#.......####..#........#   #........#
            #.......# ##..#.......#  ##.#........#####........#
            #.......# #..##.......#   #.#........#............#
            #.......###.###.......#   #............###........#
            #.......'...# #########   ###........### #........#
            #.......#####               #........#   #........#
            #########                   ##########   ##########
