       ###############
       #..............
       #.#....########
       #.#....#       
       #.#....########
       #.#............
       #.####)########
 #######.####.####### 
....................# 
 .########.########.# 
   #.##  #.#      #.# 
  ###.## #.#      #.# 
  #..#.###.#      #.# 
  ##.##.##.#      #<# 
 . #...#.#.#      #.# 
#. ##..##.##      #.# 
#. ##....#.#      #.# 
#.##..#..###      #.# 
#.#...#...#       #.# 
#<#.#.#.#.#       #.# 
#.#.#.#.###       #.# 
#.#.#...#         #.# 
#..##...####          
#..#..#..#.#.         
#....###....          
#..#..#..#            
#..##...#             
#.#.#[..#             
#.#.#.#.###           
#.#.#.#.#.#           
#.#...#...#           
 .##..#..###          
   ##..).#.#          
   ##..##.##          
   #...#.#.#          
  ##.##.##.#          
  #..#.###.#          
  ###.## #.#          
   #.##  #.#          
  ########(########## 
  ...........oo...... 
  ######.####lg...... 
       #.    ooo....  
       .     .....n.  
      ##     .......  
             ......   
             .....    
             ....     
             .        
