                                                   ##########
                             #######               #........#
                             #.....#               #.##.....#
                             #.###.#               #.##.....#
                             #.# #.#################.##.#.#.#
                             #.# #.#.#.(..............#.....#
                      ########'###^#.#.###########..###.....#
                      #.........%#.%.#.#         #...[#.#.#.#
              .       #..........###.#.#         #...##.....#
           o...       #..........+.....#         #...##.....#
    #######..$.    ####..........###.###  ########.).##.#.#.#
    #.....#..oo    #............<....#    #...........#.....#
    #.....#..oo    #..............####    #.######.####.....#
    #..)..#...K    #.....%........#       #.#    #>...#.#.#.#
    #.....# ...    #..............# #######.######.##.#.....#
    #.....#  #'#####..............# #....##........##.#.....#
    #.....# ##....................# #....##..########.#.#.#.#
    #.....# #...........########### #....'...##.....#.#.....#
    #.....# #.........o.#           #.[..###.##.###.###.....#
    #...<.# #...........#           #....<.%....# #...#.#.#.#
    ####'## ########o####           #.......##### ###.#^..(.#
    ##...#    #...##o#              #....%#####     #.#.....#
  ###..###    #.#.##.#              #.....#...#     #.#.#.#.#
  #....#      #.#.##o#              #....##.#.#######.#.....#
  #.#..#      #.#.##o#              #....##.#.......###.....#
  #.#..#      #.#'##o###            #....##.#######.# #.#.#.#
  #....#      #........#            #######.%...# #.###.....#
  ###.##      #........#                  #####'###...#.....#
  #...#       #........#                  #......######.#.#.#
###.###       #........#                  #......######.....#
#...#         #........#                  #......'...>#.....#
#.#############........#                  #.....)###........#
#.......##.............#                  #.%....# ##########
#######.##.............#                  #......#           
      #..'.............#######            #......#           
      ####.....#.............#            #......#           
         #.....######........#            #......#           
         #...%.#    #........#            #......#           
         #....%#    #........#            ########           
 #########.....#    #........#                               
 #.............#    #........#                               
 #.............#    ##########                               
 #.........#####                                             
 ###########                                                 
