                      #######   #########         
                      #.....#   #.......#         
                      #.....#   #....[..#         
                      #.....#   #.......#         
                      #.O...#####.......#         
             ##########.p...#..........##      ###
         #####...........?..#........[.#########.#
        ##......#....#...####......##..........#.#
     ####<...........'...#  #).....'....#...##...#
     #...............#...#  #......##.#.#...##.#.#
     ####..#.........##'##  #......##...#.#.##.#.#
 ########..###...........#  #.##......#.#.#.##.#.#
.............#[.##.#.##..#  #.##..#####.###......#
 ..#.....................#  #.##....#.....#....#.#
   #.#.###.#.#...##......####.##.##.#.#######....#
   # #...........##..#.#.##.#.##.##...#  ##...####
   #.####........##......#....##.######  #....##  
   #.............##.................#    #>....#  
   #.............##%###.###.........#  ###.....#  
   #.##.##..........###...(.#.......####.......#  
   # ... #....###....####.###.##......##.##..###  
   ..... ########....#  #.#.#%#############..#    
    ###       #......#  #.#.#)###         #..#    
              ###....####.#.....#         ####    
                #...............#                 
                #......#..#%%...#                 
              ###..##..#......<.#                 
              #...........#.....#                 
              ###......##......##                 
                #...#..##.#....#                  
                #..............#                  
                #.#.%..........#                  
                #...........#.##                  
              ...#...........K###                 
              ##.#.^..........o.#    ?..          
                ......#.#.....#.####?.            
                .#.##.#.....g.#.#...              
                ##. ..#####...#.#.#               
                    ..##..........#               
                     ........#....#               
                     ###.##..#.g..#               
                    ..............#.##            
                     ....##..........#            
                       #.....!#..##....           
                     .............$...            
                     .##...>..........            
                       #.##......##...            
                      ... #.....?....             
                       .  ....[..##               
                         ####.##.#                
                            #.#                   
