                             ###########                            
                             #.........#                            
          ####################.........#                            
          #....................)..._...#                            
###########.#####......#######.........#                            
#.........#.#   #......#     #.........#                            
#.......%.#.#   #......#     #.........#                            
#.........#.#   #......#     #..)......#                            
#.........#.#####......#######.#########                            
#............................(.......#                              
#.........#.#######.##########.#####.##                             
#.........#.#     #.#        #......).#                             
#.........#.#     #.#        #[.......#                             
###########.#   ###.######## #........#                             
          #o#   #.<........# #........#                             
          #.#   #........(.############                             
          #o#   #................                                   
          #.#   #..........#####                                    
          #o#   #..........#                                        
          #.#   ###.######.#                                        
          #o#     #.#    #.#   ??P                                  
          #.#     #.#    #.# ??PPP˜                                 
          #%#     #.#   ##z#?PP˜˜˜˜                                 
          #.#     #.#   #..˜˜˜˜˜˜˜˜                                 
          #.#     #.#   #..?˜P˜˜P˜˜˜                                
          #..     #.#   #...........                                
          #...    #.#   #..˜˜˜˜˜˜˜P˜                                
          #..!.   #.#   ##P˜˜˜˜˜˜˜P˜                                
          #.....  #.#    #˜˜˜˜˜˜˜˜˜?                                
          #...... #.#    #?˜˜P˜˜˜???                                
          #......##.######?P˜P˜˜˜?                                  
          #...............?˜˜˜˜˜˜?                                  
           .#######o######.˜˜P?˜??                                  
                  #.#     ?#?˜?#.#                                  
                  #.#     .  ?# .                                   
                  #.#    #.                                         
                  #.#     .                                         
                  #.#                                               
                  #.#                                               
                  #.#                                               
                  #.#                                               
                  ###                                               
