                                                          ####       
                                                          #..        
                                                          #.#        
        #######                                     #######.###      
        #.....#                                     #....(.((.#      
        #.....####                                  #................
#########........#                                  #........b#.#>## 
#..........>.....#                                  #.##.#......#    
###.#######......#                             #.####.##.#.######    
  #.#...# #......#                           ..#[#.<#.##.#g#         
###.#.#.###......#                           #.#!...#.##.#.#         
#.....#...#......##                          .....#.#.##.#.#         
#########.#.......#                        #####....#.##.#..         
      #...###.....#                        #.............#           
      ###.###.....#                        #.####.....#..#           
       #...##.....#                   ######.####..#.#...#           
       #...##.....#                   #..........)......##           
       #...##.....#                    ##..%.).$.##.###.#            
       #...##.....#                 #...................#            
       #...##.....#                 #####.........#.#####            
       #...##.....#                     #######...#.#                
       #...######.#                           ##.##..                
       #...#    #.##############################.####                
       #...#    #......#.#.#.#.#.#.#.#.#.#.#.#...#                   
       ##.##    ####.##.#.#.#.#.#.#.#.#.#.#.#.##.#                   
        #.#        #...###.###.###.###.###.###...#                   
        #.#        #.##.#.#.#.#.#.#.#.#.#.#.# ##.#                   
        #.####     #...#.#.#.# #.# #.# #.# #.# ..#                   
        #....#     ########### ### ### ###  ## ###                   
        ####.#                                                       
      ######.###########                                             
      #................#                                             
      ######.##........#                                             
           ####........#                                             
              #........#                                             
              #........#      #                                      
              #........#     .#                                      
              #........######.# #####                                
              ##..............# .....                                
               ######'#.#...#####.....                               
                  ###.#.............                                 
                  #.....<.#...#...#  ####                            
               ######.....#.#.#.#.###.....                           
               #..........#...............                           
               #............#.##..........                           
               #...............+......###                            
               #.........#######......#                              
               #.........#    #.......#                              
               #.........#    #.......#                              
               #.........#### #.......#                              
               ######.......# #.......#                              
                    #######.###.#######                              
                          #.....#                                    
                          #######                                    
